1122221222111122111221112211111111111111111111111111111111111111111111111111111111111
1          1     1    100001    1    1          1         1        1    1           1
1          1     1    100001    1    1          1         1        1    1           1
1          1     1    100001    1    1          1         1        1    1           1
1          1     1    100001    1    1          1         1        1    1           1
1    L     1  L  1 L  100001 L  1 L  1    L     1    L    1   L    1 L  1      L    1
1          1     1    100001    1    1          1         1        1    1           1
1          1     1    100001    1    1          1         1        1    1           1
1          1     1    100001    1    1          1         1        1    1           1
1          1     1    100001    1    1          1         1        11  11  1111111111
1          111  11  111  111  111  1111111  111111111  1111111  1111                1
1          1                                                       1           L    1
1          1                                                       1       1        1
      L        L       L       L          L          L        L            1111111111
                                                                           1        1
1          1                                                       1           L    1
1          1                                                       1                1
1          1111111  11111111111111111111  111111111111111  111111  1       1        1
1          1                                         1        1    1       1111111111
1          1                 1                       1        1    1       1000000001
1          1                                         1        1    1       1000000001
1          1                 1                       1        1    11  1   1000000001
1    L     1        L                   L            1    L   1    11001    000000001
1          1                 1                       1        111  11001    000000001
1          1                                         1        1    11001   1000000001
1          1                 1                       1        1    11001   1000000001
1          1                                         1        1    11111   1000000001
1111111111111111111111111111111111111111111111111111111111111111111111111111111111111